roll,caste,disability,written_total,total_marks,rank,personality_test
203955,Gen,Fit,784,963,333,179
826712,OBC,Fit,766,931,709,165
1418899,Gen,Fit,824,973,219,149
608684,Gen,Fit,777,956,426,179
1220304,OBC,Fit,780,955,449,175
6602743,OBC,Fit,759,935,661,176
2634056,EWS,Fit,785,961,363,176
1213257,Gen,Fit,798,996,79,198
3516118,Gen,Fit,816,1017,30,201
6500677,SC,Fit,740,900,945,160
331405,ST,Fit,699,898,953,199
851835,EWS,Fit,798,971,238,173
6412170,EWS,Fit,756,936,654,180
3532380,Gen,Fit,757,960,372,203
803025,SC,Fit,789,980,166,191
1211633,OBC,Fit,787,942,579,155
1908748,OBC,Fit,788,978,179,190
403799,Gen,Fit,748,953,479,205
6500154,ST,Fit,796,1001,66,205
5812561,SC,Fit,780,983,142,203
1530092,Gen,Fit,804,969,261,165
1419185,SC,Fit,707,897,955,190
7808541,ST,Fit,751,908,900,157
5901689,EWS,Fit,753,948,527,195
6317953,EWS,Fit,761,934,676,173
5805384,Gen,Fit,758,968,262,210
3700225,Gen,Fit,773,953,478,180
2628249,Gen,Fit,814,964,324,150
410848,Gen,Fit,797,973,222,176
1519555,OBC,Fit,773,931,708,158
705850,Gen,Fit,791,964,319,173
839843,Gen,Fit,804,966,293,162
1124999,ST,Fit,759,899,950,140
802613,Gen,Fit,826,1008,50,182
1530901,OBC,Fit,754,919,853,165
1013595,EWS,Fit,875,1065,3,190
5910784,EWS,Fit,739,945,553,206
801031,EWS,Fit,789,960,378,171
6620045,SC,Fit,736,905,918,169
1043498,ST,Fit,786,946,545,160
1038520,OBC,Fit,726,924,790,198
869837,OBC,PwBD-3,636,761,1011,125
4005986,OBC,Fit,768,952,500,184
1220260,OBC,Fit,765,933,683,168
1530610,Gen,Fit,817,1016,34,199
3402529,Gen,Fit,827,1017,32,190
413045,Gen,Fit,782,972,232,190
5917940,SC,Fit,742,927,760,185
4909922,Gen,Fit,786,976,193,190
1911162,Gen,Fit,750,962,347,212
1903299,Gen,Fit,874,1059,4,185
1909182,Gen,Fit,765,975,205,210
317041,EWS,Fit,771,934,671,163
809949,EWS,Fit,765,941,585,176
832016,Gen,Fit,769,964,320,195
1200593,OBC,Fit,806,996,78,190
5802783,Gen,Fit,789,995,85,206
3515754,Gen,Fit,772,965,300,193
4003066,OBC,Fit,820,995,83,175
104657,Gen,Fit,811,961,362,150
3406094,SC,Fit,789,960,381,171
1408280,OBC,Fit,749,928,744,179
5605156,OBC,Fit,753,948,528,195
804872,OBC,Fit,775,925,785,150
7909204,ST,Fit,739,932,689,193
115853,OBC,Fit,793,966,290,173
501579,Gen,Fit,862,1048,6,186
321250,SC,Fit,701,894,973,193
6314966,Gen,Fit,755,953,484,198
212013,Gen,Fit,802,992,98,190
4908916,Gen,Fit,801,955,452,154
837108,SC,Fit,753,933,680,180
231845,SC,Fit,759,913,882,154
6602328,OBC,Fit,773,968,267,195
3804659,EWS,Fit,795,956,437,161
3900058,Gen,Fit,771,955,440,184
5900318,Gen,Fit,766,964,315,198
1223082,Gen,PwBD-1,748,921,829,173
1023929,ST,Fit,731,902,938,171
6318786,Gen,Fit,829,989,119,160
6303573,EWS,Fit,819,959,383,140
7808036,SC,Fit,813,970,251,157
404314,Gen,Fit,765,955,450,190
844129,SC,Fit,790,955,448,165
2637654,OBC,Fit,890,1044,10,154
2601981,SC,Fit,771,976,197,205
234345,SC,Fit,735,890,1008,155
1031840,Gen,Fit,802,995,82,193
838876,OBC,Fit,753,923,814,170
1115543,EWS,Fit,747,952,495,205
332871,SC,Fit,764,937,631,173
853442,Gen,Fit,811,971,240,160
1145916,Gen,PwBD-3,697,843,1010,146
2633769,Gen,Fit,795,974,212,179
6316307,OBC,Fit,773,928,747,155
6311305,OBC,Fit,725,935,656,210
303613,SC,Fit,700,890,1006,190
867587,Gen,Fit,798,973,228,175
4403405,ST,Fit,729,916,870,187
1104109,OBC,Fit,765,941,586,176
1041911,SC,Fit,763,923,810,160
1420215,Gen,Fit,772,978,178,206
1905551,Gen,Fit,779,954,468,175
627108,SC,Fit,736,951,508,215
6210733,Gen,Fit,753,953,487,200
1206261,SC,Fit,795,963,329,168
856573,SC,Fit,785,928,753,143
1121316,Gen,Fit,866,1045,8,179
7910177,Gen,Fit,807,982,156,175
2609745,SC,Fit,775,945,550,170
903017,OBC,Fit,766,945,552,179
5810634,OBC,Fit,757,952,501,195
855968,SC,Fit,713,892,991,179
1902650,OBC,Fit,745,924,791,179
1203767,OBC,Fit,777,942,576,165
6617121,EWS,Fit,780,923,815,143
6313284,OBC,Fit,773,941,588,168
6316878,SC,Fit,745,899,949,154
1909835,OBC,Fit,760,942,577,182
3500516,OBC,Fit,777,956,434,179
507980,OBC,Fit,757,947,539,190
3533825,SC,PwBD-1,743,908,902,165
7914880,SC,Fit,722,907,905,185
701666,Gen,Fit,803,954,466,151
857513,SC,Fit,732,902,937,170
2205307,Gen,Fit,805,973,229,168
4901079,Gen,Fit,760,955,443,195
7304535,OBC,Fit,789,929,741,140
803419,Gen,Fit,814,974,213,160
106819,Gen,Fit,823,996,80,173
6121661,Gen,Fit,772,982,149,210
2607330,Gen,Fit,772,965,303,193
1040972,EWS,Fit,758,943,568,185
6313532,OBC,Fit,750,923,807,173
5110787,OBC,PwBD-1,706,911,887,205
826498,EWS,Fit,755,935,657,180
6315142,OBC,Fit,763,934,665,171
851477,Gen,Fit,792,962,352,170
1418701,Gen,Fit,814,985,134,171
1910944,OBC,Fit,773,944,559,171
1005495,Gen,Fit,777,965,312,188
1101080,OBC,Fit,738,938,618,200
3400060,SC,Fit,731,891,1003,160
302423,OBC,Fit,739,924,802,185
2629523,Gen,Fit,899,1099,1,200
1910931,Gen,Fit,794,964,317,170
6317797,OBC,Fit,748,930,719,182
7103607,EWS,Fit,753,923,808,170
6310878,Gen,Fit,761,961,358,200
8900162,SC,Fit,727,922,824,195
600672,OBC,Fit,782,952,496,170
1137036,OBC,Fit,751,959,389,208
1033984,Gen,Fit,780,980,173,200
6500430,SC,Fit,794,987,126,193
3401799,Gen,Fit,784,957,412,173
1134436,OBC,Fit,786,936,650,150
7201464,SC,Fit,729,894,978,165
6404629,ST,Fit,737,905,917,168
6305241,Gen,Fit,814,993,91,179
852672,SC,Fit,748,898,954,150
859243,Gen,Fit,813,978,182,165
6307371,SC,Fit,790,961,364,171
205828,Gen,Fit,797,968,275,171
1703444,ST,Fit,762,907,909,145
6608942,OBC,Fit,835,1000,70,165
6406589,Gen,Fit,771,966,292,195
2201730,Gen,Fit,780,985,132,205
866714,Gen,Fit,779,965,301,186
6616832,OBC,Fit,809,949,523,140
6408471,Gen,Fit,757,963,327,206
6606372,Gen,Fit,783,983,145,200
1301067,SC,Fit,751,955,441,204
862830,SC,Fit,775,940,592,165
840861,SC,Fit,757,927,761,170
816567,OBC,Fit,814,985,136,171
6500649,Gen,Fit,780,956,425,176
621263,Gen,Fit,787,980,165,193
6311776,Gen,Fit,828,1018,29,190
2611470,OBC,Fit,788,943,571,155
6316725,OBC,Fit,764,976,194,212
806426,Gen,Fit,796,958,405,162
853741,EWS,Fit,755,925,786,170
6318990,OBC,Fit,831,980,170,149
1905195,OBC,Fit,766,951,507,185
7002266,Gen,Fit,793,983,141,190
3518500,Gen,Fit,820,980,174,160
3406060,Gen,Fit,839,1045,7,206
1117204,OBC,Fit,771,936,653,165
1123530,EWS,Fit,760,950,517,190
824739,Gen,Fit,824,997,74,173
1205271,OBC,Fit,789,932,695,143
507442,OBC,Fit,763,948,533,185
808124,EWS,Fit,786,971,239,185
810144,Gen,Fit,821,983,146,162
824770,ST,Fit,749,919,858,170
1908483,Gen,Fit,785,972,235,187
817652,Gen,Fit,823,973,221,150
818520,ST,Fit,773,952,494,179
2109336,EWS,Fit,766,934,670,168
1903220,Gen,Fit,787,985,133,198
7203384,SC,Fit,725,890,1007,165
332735,SC,Fit,743,901,939,158
322692,SC,Fit,761,934,667,173
804270,Gen,Fit,818,978,186,160
1310792,OBC,Fit,834,1010,42,176
6311612,EWS,Fit,778,938,622,160
1111648,Gen,Fit,801,991,109,190
319250,OBC,Fit,797,940,600,143
1700975,OBC,Fit,828,1004,57,176
813458,Gen,Fit,802,957,423,155
1303580,SC,Fit,760,935,658,175
1214053,OBC,Fit,753,943,573,190
2626715,SC,Fit,761,915,874,154
6207400,Gen,Fit,837,1024,25,187
849764,OBC,Fit,806,946,544,140
1905033,OBC,Fit,779,919,855,140
6410713,OBC,Fit,797,947,540,150
1910042,OBC,Fit,769,937,630,168
8601355,OBC,Fit,783,931,706,148
811492,SC,Fit,730,901,941,171
820224,Gen,Fit,752,962,339,210
8101557,Gen,Fit,806,1006,52,200
412743,Gen,Fit,759,959,384,200
5803647,EWS,Fit,751,949,524,198
856924,SC,Fit,732,902,935,170
321011,OBC,Fit,763,936,644,173
810172,Gen,Fit,775,968,265,193
1314318,OBC,Fit,766,946,546,180
821859,SC,Fit,765,930,723,165
409901,OBC,Fit,772,932,694,160
1111382,Gen,Fit,763,958,396,195
304214,OBC,Fit,779,949,526,170
5703673,OBC,Fit,779,954,465,175
331058,OBC,Fit,842,1029,19,187
2630225,OBC,Fit,762,919,859,157
1220936,OBC,Fit,759,952,502,193
1004690,ST,Fit,724,906,914,182
6318093,EWS,Fit,795,955,451,160
6306030,EWS,Fit,794,960,368,166
6900262,Gen,Fit,815,995,84,180
6413572,Gen,Fit,808,1001,62,193
867887,SC,Fit,712,901,940,189
849486,Gen,Fit,794,968,273,174
837816,Gen,Fit,797,967,286,170
810258,OBC,Fit,796,961,361,165
3528553,OBC,Fit,787,962,355,175
413430,EWS,Fit,750,950,515,200
1405935,Gen,Fit,769,967,279,198
813845,Gen,Fit,875,1040,13,165
101156,Gen,Fit,788,978,183,190
1803331,Gen,Fit,767,960,369,193
337734,Gen,PwBD-2,740,930,721,190
1038416,ST,Fit,759,938,627,179
1314865,OBC,PwBD-2,803,973,224,170
836154,OBC,Fit,766,941,583,175
1039442,OBC,Fit,765,930,718,165
1540578,OBC,Fit,759,932,688,173
1909789,SC,Fit,730,910,888,180
1908460,OBC,Fit,739,940,594,201
6616402,OBC,Fit,730,923,809,193
3404295,Gen,Fit,789,979,177,190
833285,SC,Fit,750,925,784,175
1003272,ST,Fit,776,936,639,160
842613,SC,Fit,758,940,597,182
862145,OBC,Fit,774,954,457,180
1903429,EWS,Fit,747,948,529,201
2621421,Gen,Fit,774,959,394,185
5812394,OBC,Fit,787,980,164,193
2618669,OBC,Fit,785,970,249,185
602125,SC,Fit,736,923,812,187
1040585,SC,Fit,718,908,899,190
833086,SC,Fit,773,933,681,160
334267,EWS,Fit,781,960,376,179
6309929,EWS,Fit,797,957,413,160
841992,EWS,Fit,812,997,75,185
1532788,EWS,Fit,797,990,114,193
327675,OBC,Fit,759,934,668,175
4906073,ST,Fit,770,943,569,173
6317840,Gen,Fit,761,959,391,198
410728,EWS,Fit,801,991,105,190
6312569,Gen,Fit,802,989,115,187
812484,Gen,Fit,799,957,418,158
511333,ST,Fit,727,892,992,165
5809597,Gen,Fit,777,954,458,177
841723,Gen,Fit,788,958,410,170
1905060,Gen,Fit,808,993,93,185
900223,ST,Fit,704,909,891,205
1136246,Gen,Fit,804,994,90,190
816163,Gen,Fit,768,963,337,195
100182,SC,Fit,719,890,1005,171
861596,ST,Fit,737,902,936,165
848555,SC,Fit,725,899,948,174
4123734,OBC,Fit,758,938,617,180
1403344,OBC,Fit,804,939,605,135
812084,OBC,Fit,786,938,623,152
6400192,Gen,Fit,836,993,95,157
5818509,Gen,Fit,826,1041,12,215
6314442,OBC,Fit,753,958,397,205
819214,OBC,Fit,762,947,542,185
4100790,Gen,Fit,810,1010,44,200
8704716,EWS,Fit,845,1010,43,165
5913455,OBC,Fit,779,963,330,184
861073,Gen,Fit,823,980,168,157
1539628,OBC,Fit,747,957,417,210
2618097,SC,Fit,714,909,890,195
1534867,SC,Fit,771,936,645,165
7906215,SC,Fit,739,919,849,180
3911472,Gen,Fit,810,992,101,182
865741,Gen,Fit,752,956,427,204
3525812,ST,Fit,733,908,896,175
5900639,SC,Fit,694,894,977,200
321213,OBC,Fit,750,932,696,182
847801,SC,Fit,756,931,704,175
8603316,EWS,Fit,790,969,258,179
1212220,OBC,Fit,787,963,336,176
415007,Gen,Fit,872,1032,16,160
7300036,ST,Fit,732,930,713,198
853299,Gen,Fit,756,964,325,208
5605398,SC,Fit,738,926,771,188
6302245,Gen,Fit,816,973,223,157
1127462,SC,Fit,778,978,180,200
6301025,ST,Fit,714,891,1000,177
1907917,OBC,Fit,754,949,522,195
308283,Gen,Fit,846,1025,23,179
6105150,Gen,Fit,751,961,357,210
1204812,OBC,Fit,731,933,678,202
813478,SC,Fit,745,915,875,170
7918022,Gen,PwBD-2,762,962,341,200
865097,Gen,Fit,785,956,432,171
6319404,OBC,Fit,768,944,560,176
6305413,SC,Fit,729,919,847,190
5805443,EWS,Fit,773,975,204,202
414331,OBC,Fit,767,927,758,160
863534,Gen,Fit,814,993,94,179
400900,SC,Fit,741,896,964,155
1542748,Gen,Fit,807,1000,69,193
836793,EWS,Fit,766,937,634,171
852633,Gen,Fit,788,967,285,179
5102086,OBC,Fit,727,922,818,195
802268,OBC,Fit,788,956,435,168
2618446,Gen,Fit,782,982,154,200
6311142,Gen,Fit,810,997,76,187
2636524,OBC,Fit,730,920,835,190
2611562,EWS,Fit,793,955,447,162
4904375,Gen,Fit,801,977,189,176
4117353,Gen,Fit,775,968,272,193
508803,OBC,Fit,776,971,237,195
856301,EWS,Fit,782,953,488,171
2638050,Gen,Fit,814,989,118,175
7917836,OBC,PwBD-1,726,897,962,171
5606279,OBC,Fit,760,950,513,190
1108639,ST,Fit,746,903,933,157
415481,SC,Fit,746,939,603,193
6117690,Gen,Fit,807,987,127,180
832948,Gen,Fit,810,989,117,179
5917924,EWS,Fit,809,954,474,145
1209325,OBC,Fit,766,931,705,165
854302,Gen,Fit,811,1004,58,193
843357,SC,Fit,745,933,686,188
5919197,SC,Fit,734,904,926,170
805855,EWS,Fit,767,960,370,193
605880,Gen,Fit,803,968,269,165
5803862,OBC,Fit,827,1009,47,182
818251,SC,Fit,812,962,350,150
1036075,OBC,Fit,791,976,196,185
1543882,OBC,PwBD-5,469,589,1016,120
6317179,OBC,Fit,749,919,848,170
5704673,OBC,PwBD-1,731,904,922,173
1902657,OBC,Fit,779,922,827,143
809128,Gen,Fit,775,968,264,193
1216634,OBC,Fit,770,955,444,185
814591,SC,Fit,716,895,968,179
2601323,Gen,Fit,789,965,305,176
3521957,Gen,Fit,778,962,342,184
1530854,EWS,Fit,750,929,735,179
848792,ST,Fit,703,893,983,190
105419,OBC,Fit,844,982,150,138
1101934,EWS,Fit,805,987,125,182
7904524,OBC,Fit,739,924,799,185
5109674,OBC,Fit,719,920,836,201
6702296,OBC,Fit,812,1007,51,195
4003798,OBC,Fit,789,962,354,173
1032273,ST,Fit,739,901,942,162
4002406,Gen,Fit,773,983,143,210
862625,Gen,Fit,804,954,471,150
1700101,Gen,Fit,763,958,400,195
843561,EWS,Fit,777,937,637,160
8204019,OBC,Fit,769,964,321,195
5804350,Gen,Fit,843,1028,20,185
1117199,ST,Fit,742,922,823,180
817759,OBC,Fit,749,924,803,175
1700265,SC,Fit,758,904,924,146
1121314,OBC,Fit,785,958,408,173
3904364,OBC,Fit,787,947,538,160
6907460,EWS,Fit,764,937,632,173
6305930,Gen,Fit,874,1012,39,138
5301719,Gen,Fit,786,979,176,193
1903956,Gen,Fit,765,970,246,205
6313500,OBC,Fit,755,920,842,165
828594,EWS,Fit,783,933,679,150
4001377,OBC,Fit,758,920,845,162
6310496,SC,Fit,726,903,931,177
6609388,OBC,Fit,820,982,155,162
815120,Gen,Fit,786,966,288,180
840812,SC,Fit,737,938,614,201
1222523,OBC,Fit,781,943,570,162
1024148,OBC,Fit,777,928,756,151
5818283,Gen,Fit,832,1030,18,198
6621023,Gen,Fit,797,986,128,189
1203292,Gen,Fit,814,964,323,150
233645,Gen,Fit,784,969,256,185
6617785,OBC,Fit,771,934,669,163
6700598,ST,Fit,706,893,981,187
6630850,OBC,PwBD-1,826,977,191,151
2633656,Gen,Fit,804,989,116,185
502070,SC,Fit,709,894,980,185
848373,ST,Fit,769,939,607,170
859598,OBC,Fit,818,978,181,160
6701576,Gen,Fit,775,965,302,190
4910520,SC,Fit,720,904,925,184
867969,ST,Fit,742,907,906,165
1105660,OBC,Fit,743,928,755,185
7708511,Gen,PwBD-2,752,932,697,180
6501852,OBC,Fit,763,933,685,170
1134566,OBC,Fit,744,950,518,206
703438,ST,Fit,718,891,1001,173
3527471,Gen,Fit,819,1009,46,190
102259,SC,Fit,724,904,923,180
828813,Gen,Fit,816,981,158,165
4403896,OBC,Fit,771,928,757,157
904301,Gen,Fit,812,980,172,168
838034,Gen,Fit,844,1031,17,187
844804,OBC,Fit,766,951,512,185
6308058,Gen,Fit,812,1008,49,196
8501096,SC,Fit,736,893,988,157
806091,OBC,Fit,770,919,854,149
3408265,ST,Fit,738,950,516,212
5603734,OBC,Fit,737,932,698,195
1003785,OBC,Fit,782,953,481,171
5911092,Gen,Fit,793,967,284,174
328344,OBC,Fit,759,929,731,170
6318835,OBC,Fit,741,934,666,193
829137,Gen,Fit,811,973,226,162
1026031,OBC,Fit,837,1022,27,185
1910863,OBC,Fit,744,920,843,176
3528340,Gen,Fit,770,955,438,185
812252,SC,Fit,758,896,966,138
2623649,Gen,Fit,801,961,365,160
901164,Gen,Fit,797,972,230,175
2612095,SC,Fit,839,1014,38,175
1419905,SC,Fit,714,893,982,179
6319581,Gen,Fit,770,960,375,190
408536,OBC,Fit,767,954,470,187
6314768,SC,Fit,733,893,984,160
4005797,SC,Fit,732,917,864,185
6303670,OBC,Fit,754,930,716,176
6618035,EWS,Fit,767,929,738,162
2405152,Gen,Fit,783,976,195,193
319747,SC,Fit,741,916,868,175
413602,SC,Fit,724,914,878,190
509633,SC,Fit,772,952,504,180
7813678,SC,Fit,714,893,986,179
848260,OBC,Fit,758,920,844,162
1027146,SC,Fit,765,941,580,176
1002464,ST,Fit,718,893,985,175
1529501,Gen,Fit,831,981,163,150
1900578,OBC,Fit,752,930,714,178
855326,Gen,Fit,787,982,153,195
848312,SC,Fit,748,932,693,184
1207496,OBC,Fit,770,930,712,160
909524,ST,Fit,736,926,768,190
1041461,Gen,Fit,817,990,112,173
405557,Gen,Fit,808,973,227,165
1022336,SC,Fit,727,895,972,168
8202675,Gen,Fit,781,991,104,210
6621186,Gen,Fit,803,957,422,154
867177,Gen,Fit,777,957,420,180
1506395,OBC,Fit,767,927,763,160
810101,EWS,Fit,776,941,587,165
825213,OBC,Fit,769,924,793,155
1122361,OBC,Fit,759,934,673,175
5805438,OBC,Fit,793,988,120,195
1109551,Gen,Fit,821,1005,54,184
1201397,OBC,Fit,802,982,152,180
334084,OBC,Fit,779,958,404,179
232340,SC,Fit,735,897,960,162
6310924,Gen,Fit,774,974,208,200
4001451,OBC,Fit,775,935,659,160
821779,ST,Fit,737,910,889,173
8603164,ST,Fit,768,926,775,158
6016094,Gen,Fit,863,1045,9,182
6201908,OBC,Fit,724,922,821,198
6304114,Gen,Fit,802,1014,37,212
6123357,OBC,Fit,759,954,453,195
6314197,EWS,Fit,776,936,652,160
861283,OBC,Fit,779,969,254,190
814592,Gen,Fit,772,965,304,193
6609479,OBC,Fit,748,927,759,179
5909318,EWS,Fit,750,943,572,193
1512860,EWS,Fit,765,938,624,173
1400023,OBC,Fit,776,930,722,154
6603071,OBC,Fit,764,929,732,165
6318159,Gen,Fit,758,968,263,210
7501963,OBC,Fit,784,939,611,155
2610149,OBC,Fit,790,965,298,175
3527720,Gen,Fit,767,957,415,190
4107037,Gen,Fit,782,982,151,200
1412296,OBC,Fit,769,924,801,155
832387,OBC,Fit,760,936,641,176
619715,ST,Fit,738,908,903,170
803175,OBC,Fit,780,945,551,165
859873,EWS,Fit,768,923,804,155
6420991,Gen,Fit,807,953,489,146
1013702,EWS,Fit,751,930,711,179
6202696,Gen,Fit,792,982,148,190
6628669,OBC,Fit,818,983,147,165
6412830,EWS,Fit,758,929,733,171
109438,ST,Fit,742,899,946,157
825417,EWS,Fit,755,928,752,173
866934,SC,Fit,737,935,660,198
7501764,OBC,Fit,802,962,349,160
6319162,OBC,Fit,794,954,464,160
6800430,Gen,Fit,789,964,326,175
1131702,OBC,Fit,767,977,187,210
6302486,Gen,Fit,778,988,124,210
3505730,SC,Fit,772,917,867,145
1134064,OBC,Fit,765,939,609,174
117376,SC,Fit,807,983,144,176
8703373,ST,Fit,744,894,975,150
1020990,Gen,Fit,783,976,198,193
852705,OBC,Fit,804,939,610,135
3530112,Gen,Fit,807,967,280,160
850038,SC,Fit,795,966,294,171
6319021,OBC,Fit,750,958,401,208
860811,Gen,Fit,817,988,123,171
805942,Gen,Fit,824,978,184,154
3518893,Gen,Fit,797,976,203,179
1912138,Gen,Fit,760,955,439,195
1406754,Gen,Fit,778,970,247,192
2638776,Gen,Fit,762,957,416,195
832165,EWS,Fit,731,924,789,193
847251,ST,Fit,816,926,778,110
1124093,ST,Fit,751,905,920,154
2404191,OBC,Fit,735,925,781,190
303723,ST,Fit,743,908,901,165
5805571,OBC,Fit,824,986,130,162
1902529,SC,Fit,736,936,638,200
6306567,EWS,Fit,757,958,403,201
8602528,EWS,Fit,737,924,797,187
7805618,SC,Fit,741,895,971,154
7300970,ST,Fit,756,929,736,173
1101311,ST,Fit,723,903,927,180
1912430,Gen,Fit,773,973,220,200
6901939,EWS,Fit,786,936,642,150
3600913,ST,Fit,741,903,929,162
857276,EWS,Fit,757,927,765,170
1128816,OBC,Fit,746,922,820,176
7600705,SC,Fit,702,902,934,200
1133033,ST,Fit,798,938,625,140
1905483,OBC,Fit,754,919,852,165
1043287,ST,Fit,715,915,873,200
5300726,Gen,Fit,777,959,387,182
6602914,SC,Fit,731,893,989,162
909210,OBC,Fit,750,951,510,201
2406502,Gen,Fit,783,968,268,185
822564,SC,Fit,761,921,833,160
7907261,Gen,Fit,765,955,442,190
2206857,OBC,Fit,784,952,497,168
2604129,Gen,Fit,803,990,113,187
1124051,OBC,Fit,752,932,692,180
3518081,Gen,Fit,799,972,233,173
215171,SC,Fit,740,913,883,173
1217569,OBC,Fit,756,939,608,183
837686,ST,Fit,749,934,672,185
1523979,EWS,Fit,760,960,374,200
849025,ST,Fit,718,891,998,173
830286,OBC,Fit,740,919,856,179
864044,OBC,Fit,818,972,234,154
857924,SC,Fit,737,893,990,156
6408946,EWS,Fit,794,934,677,140
6121986,Gen,Fit,777,964,318,187
1021388,SC,Fit,782,936,649,154
1004705,Gen,Fit,781,957,411,176
5903873,SC,Fit,721,906,912,185
800463,EWS,Fit,769,931,710,162
6623626,OBC,Fit,781,961,359,180
2608537,Gen,Fit,794,969,259,175
5701144,OBC,Fit,723,928,745,205
6313708,EWS,Fit,814,938,628,124
405487,EWS,Fit,762,937,633,175
1117729,ST,Fit,797,967,283,170
812285,Gen,Fit,778,960,377,182
864419,OBC,Fit,774,959,385,185
1908326,Gen,Fit,822,973,225,151
860553,SC,Fit,735,895,970,160
854833,SC,Fit,782,922,828,140
869785,Gen,PwBD-1,792,954,473,162
1222911,OBC,Fit,761,962,348,201
107322,EWS,Fit,761,951,506,190
868087,EWS,Fit,749,936,640,187
6302231,SC,Fit,729,891,1004,162
867939,ST,Fit,754,924,798,170
1306535,SC,Fit,701,901,943,200
802299,ST,Fit,754,905,919,151
321373,OBC,Fit,767,938,620,171
7903247,SC,Fit,733,916,869,183
1414109,SC,Fit,766,923,817,157
2002343,OBC,Fit,734,936,646,202
2605584,SC,Fit,743,919,860,176
6120474,OBC,Fit,785,945,557,160
2637220,SC,Fit,714,894,974,180
1124938,OBC,Fit,804,942,578,138
5605346,OBC,Fit,764,924,796,160
1416657,Gen,Fit,811,995,86,184
335167,OBC,Fit,769,970,243,201
854082,SC,Fit,757,932,699,175
303894,OBC,Fit,805,981,160,176
1543028,OBC,Fit,799,949,525,150
713649,Gen,Fit,845,1015,36,170
5415753,EWS,Fit,790,947,541,157
1121761,OBC,Fit,800,980,171,180
6608088,OBC,Fit,782,936,655,154
1214568,SC,Fit,738,907,904,169
845350,SC,Fit,741,916,871,175
8704918,Gen,PwBD-5,478,628,1014,150
1413451,ST,Fit,712,897,959,185
6303493,EWS,Fit,763,929,734,166
406147,Gen,Fit,832,992,96,160
865972,OBC,Fit,782,944,564,162
816673,EWS,Fit,796,971,241,175
841336,OBC,Fit,783,929,743,146
713076,OBC,Fit,764,942,575,178
3528450,ST,Fit,750,932,691,182
1419908,Gen,Fit,799,954,461,155
1018169,SC,Fit,765,945,554,180
1119914,ST,Fit,744,909,892,165
337056,Gen,Fit,810,975,207,165
6305299,Gen,Fit,804,959,393,155
301615,OBC,Fit,753,924,795,171
1905459,Gen,Fit,785,958,398,173
8604027,OBC,Fit,767,927,767,160
6622921,SC,Fit,739,918,862,179
844528,Gen,Fit,765,973,218,208
6312407,Gen,Fit,856,1049,5,193
805209,OBC,Fit,733,926,769,193
800504,SC,Fit,766,936,643,170
5808289,ST,Fit,724,906,911,182
815667,OBC,Fit,757,939,613,182
1034265,OBC,Fit,769,929,739,160
853811,EWS,Fit,781,946,547,165
1903925,OBC,Fit,750,929,726,179
2001910,SC,Fit,763,933,684,170
1510778,Gen,Fit,780,992,99,212
6410459,OBC,Fit,728,923,805,195
7806464,OBC,Fit,759,929,728,170
5919231,OBC,Fit,764,943,574,179
114960,Gen,Fit,785,958,407,173
4105030,OBC,Fit,802,952,503,150
5816635,SC,Fit,815,1008,48,193
1418091,Gen,Fit,804,1016,33,212
1043579,EWS,Fit,743,925,780,182
5701106,OBC,Fit,782,920,840,138
1416040,Gen,Fit,826,976,201,150
803333,ST,Fit,834,985,135,151
500060,Gen,Fit,826,1021,28,195
2639955,OBC,PwBD-1,744,909,894,165
6301887,Gen,Fit,793,972,231,179
106438,EWS,Fit,788,953,490,165
1535596,OBC,Fit,728,926,773,198
308594,Gen,Fit,784,960,379,176
6500906,Gen,Fit,783,966,289,183
869937,Gen,PwBD-1,792,957,419,165
864214,SC,Fit,769,934,675,165
108731,Gen,Fit,774,959,392,185
6501409,EWS,Fit,753,940,593,187
6309798,OBC,Fit,767,952,499,185
802671,Gen,Fit,805,984,139,179
6303474,Gen,Fit,826,1001,63,175
7500107,OBC,Fit,804,954,472,150
1139490,OBC,Fit,757,936,648,179
828755,Gen,Fit,818,986,129,168
5202671,ST,Fit,722,892,993,170
225602,EWS,Fit,769,949,521,180
1906451,OBC,Fit,733,920,839,187
6404373,SC,Fit,729,894,979,165
6416090,Gen,Fit,816,1001,65,185
412623,OBC,Fit,763,923,813,160
2205311,Gen,Fit,840,1033,15,193
6420516,EWS,Fit,805,981,157,176
1220026,OBC,Fit,835,1011,41,176
5104398,SC,Fit,771,953,493,182
843840,Gen,Fit,767,960,380,193
1540915,Gen,Fit,792,977,188,185
6302355,EWS,Fit,757,927,764,170
1045444,Gen,PwBD-1,798,974,217,176
1201545,OBC,Fit,744,924,792,180
1106390,OBC,Fit,816,1006,53,190
5904397,SC,Fit,754,914,879,160
6415008,Gen,Fit,758,962,338,204
4301299,ST,Fit,722,928,749,206
6605822,OBC,Fit,770,930,720,160
241571,EWS,Fit,770,930,725,160
864033,Gen,Fit,771,966,296,195
107364,SC,Fit,736,931,702,195
1100994,Gen,Fit,797,970,252,173
5808628,OBC,Fit,767,929,727,162
842907,Gen,Fit,744,954,462,210
6302831,Gen,Fit,767,954,456,187
869875,EWS,PwBD-3,641,756,1013,115
5807649,OBC,Fit,763,923,816,160
2625606,SC,Fit,733,918,863,185
8601810,Gen,Fit,775,968,270,193
4903790,Gen,Fit,789,976,202,187
1036014,Gen,Fit,810,981,162,171
853200,EWS,Fit,760,945,556,185
6416818,OBC,Fit,764,929,730,165
318706,Gen,Fit,774,958,402,184
1041009,ST,Fit,767,931,703,164
1900430,Gen,Fit,763,953,477,190
6419608,OBC,Fit,727,922,822,195
6407365,EWS,Fit,761,926,772,165
862817,Gen,Fit,808,991,106,183
620381,SC,Fit,779,944,566,165
845950,Gen,Fit,799,959,390,160
6312512,Gen,Fit,892,1067,2,175
6312819,ST,Fit,728,898,952,170
507394,SC,Fit,711,891,999,180
6501721,EWS,Fit,762,944,562,182
113013,SC,Fit,738,903,932,165
6701477,Gen,Fit,806,996,81,190
5905422,Gen,Fit,810,975,206,165
861853,Gen,Fit,850,1015,35,165
106595,EWS,Fit,786,926,776,140
4115712,SC,Fit,764,951,509,187
3524340,Gen,Fit,756,956,428,200
1219696,Gen,Fit,783,954,455,171
1121205,Gen,Fit,792,960,367,168
4107539,Gen,Fit,803,993,92,190
3522384,Gen,Fit,767,962,340,195
6418752,ST,Fit,719,908,898,189
839257,EWS,Fit,759,944,565,185
603929,OBC,Fit,756,962,346,206
7304712,OBC,Fit,761,926,777,165
406166,Gen,Fit,758,970,242,212
867419,Gen,Fit,839,1034,14,195
801157,EWS,Fit,769,964,316,195
821577,OBC,Fit,778,940,601,162
3402130,EWS,Fit,780,959,388,179
5805447,Gen,Fit,798,968,274,170
4122578,Gen,Fit,820,980,167,160
402380,SC,Fit,755,920,841,165
869863,Gen,PwBD-3,722,847,1009,125
856760,ST,Fit,760,936,647,176
4123999,OBC,Fit,741,922,819,181
822014,OBC,Fit,782,953,485,171
1136543,ST,Fit,740,892,997,152
825084,EWS,Fit,782,952,505,170
1215466,OBC,Fit,752,921,832,169
800577,Gen,Fit,775,970,244,195
6318167,SC,Fit,763,943,567,180
814309,ST,Fit,730,914,876,184
804675,OBC,Fit,771,944,563,173
1029017,ST,Fit,700,895,969,195
504559,ST,Fit,782,933,687,151
4119547,SC,Fit,732,897,958,165
6600139,Gen,Fit,784,977,190,193
1524355,OBC,Fit,763,925,783,162
6622743,OBC,Fit,767,932,700,165
3500702,Gen,Fit,758,953,476,195
6316898,OBC,Fit,748,933,682,185
6419451,OBC,Fit,776,951,511,175
1903257,Gen,Fit,825,1004,59,179
1041151,Gen,Fit,781,954,475,173
1901765,OBC,Fit,765,944,561,179
814548,OBC,Fit,754,919,857,165
331796,EWS,Fit,760,928,748,168
848129,Gen,Fit,784,970,253,186
8500883,Gen,Fit,815,1025,22,210
1217368,OBC,Fit,771,964,314,193
807787,Gen,Fit,769,954,460,185
1141969,Gen,Fit,805,981,161,176
7800025,EWS,Fit,782,967,277,185
1912938,OBC,PwBD-1,702,897,956,195
7102441,Gen,Fit,775,976,192,201
203174,Gen,Fit,794,959,386,165
805189,SC,Fit,748,923,806,175
6609595,EWS,Fit,792,957,414,165
6607547,SC,Fit,815,953,492,138
6300338,OBC,Fit,769,962,344,193
1036484,OBC,Fit,726,926,770,200
1529517,Gen,Fit,800,965,309,165
3529079,OBC,Fit,775,935,662,160
868492,EWS,Fit,815,986,131,171
304624,OBC,Fit,764,935,664,171
1527289,SC,Fit,745,916,872,171
3906761,Gen,Fit,802,992,100,190
6419395,Gen,Fit,780,960,373,180
1801459,Gen,Fit,810,994,88,184
335021,OBC,Fit,759,954,459,195
1912313,Gen,Fit,783,963,331,180
1538743,Gen,Fit,823,974,215,151
1015895,OBC,Fit,804,954,467,150
8603752,OBC,Fit,823,988,122,165
300089,OBC,Fit,753,938,615,185
1101464,Gen,Fit,843,1028,21,185
1909819,OBC,Fit,747,931,701,184
1407611,Gen,Fit,829,999,72,170
6317175,Gen,Fit,809,991,107,182
4115260,Gen,Fit,797,968,271,171
2605832,SC,Fit,749,919,861,170
6306233,Gen,Fit,805,956,436,151
7908817,Gen,Fit,801,991,103,190
